20 20
####################
#.##.............#.#
#.##.###..R.###....#
#....#...###########
######...#.........#
#........######....#
#...#....#....#....#
#####....#....#....#
#........#....#....#
#..................#
#########.....#....#
#E......#.....#....#
####....#.....#....#
#..#.####...########
#.....###..........#
#.......#.....#....#
#.......#.....#....#
#.............#....#
#.............#....#
####################